   ##############################################################################################
      #                 #                    #  #  #           #        #  #     #        #     #
####  ####  ####  ##########  ####  ##########  #  #  ####  #######  #  #  ####  #######  #  ####
#        #     #        #  #     #  #     #        #     #        #  #           #              #
####  ####  #######  #  #  #######  #  ####  ####  #  #  #######  #  ####  #  ####  #######  #  #
#  #     #  #        #  #        #     #  #  #        #     #        #     #  #  #     #  #  #  #
#  #  ####  #######  #  ####  ####  #  #  #  #  #  ####  #  #######  ####  ####  ####  #  ####  #
#     #  #  #     #  #  #           #     #  #  #  #  #  #  #        #           #  #        #  #
#  ####  #######  #  ####  ##########  #  #  ####  #  #  #  ####  #  #############  #######  #  #
#        #     #  #  #     #  #     #  #        #  #     #     #  #  #  #                    #  #
#  #######  ####  #  #  #  #  ####  ####  ################  #  ####  #  #  ####  #  ####  #######
#     #              #  #  #     #  #     #           #     #  #     #        #  #  #  #        #
####  #  ####  #######  ####  #  #  #######  #  ####  #  #######  ####  ####  ####  #  #  #  ####
#  #  #     #                 #     #  #  #  #  #     #     #              #  #     #     #  #  #
#  #  #  #######  #############  #  #  #  ####  ####  ##########  #######  ####  #######  ####  #
#        #     #           #  #  #  #              #     #        #  #  #     #  #        #     #
#  ##########  #  #######  #  ###################  #  ####  #######  #  #  #  #  ####  #  ####  #
#  #  #  #           #  #           #           #  #     #           #     #  #     #  #  #     #
#  #  #  #  ####  ####  ####  ##########  ####  ####  ################  ##########  ####  ####  #
#  #  #     #     #        #           #  #  #  #           #  #     #        #  #  #           #
####  #  #  #######  ####  #############  #  ##########  ####  ####  #  ####  #  #  ####  #######
#        #        #  #     #     #  #  #  #        #        #        #     #  #        #     #  #
####  ##########  #  #  #######  #  #  #  #  ####  ####  #######  ####  #############  #######  #
#  #  #  #     #     #  #     #     #           #        #  #           #              #  #     #
#  #  #  #  #######  ####  #######  #  #######  #  ####  #  #  ###################  #  #  #  #  #
#     #  #  #        #     #  #     #     #     #     #                       #     #        #  #
#######  #  ####  #######  #  #  ####  #######  #######  #######  #  ###################  #  #  #
#        #     #     #              #     #        #  #  #        #  #     #  #        #  #  #  #
#  #  #######  #  ##########  ###################  #  ##########  #  #  ####  #  #  ####  #  #  #
#  #  #                                         #  #  #  #        #     #     #  #        #  #  #
#  ################  #######  #  #  ####  ##########  #  ####  #  ####  #  ####  ####  #  ####  #
#           #     #        #  #  #  #  #     #           #     #  #        #  #  #     #  #     #
#  #  #######  #######  #  ####  ####  #  ####  #  ####  #############  #  #  ####  #  ##########
#  #                 #  #  #           #        #     #  #        #     #     #  #  #  #        #
#  #  #############  ####  #######  #  #  ##########  #######  ################  #######  #######
#  #     #     #           #     #  #  #     #     #     #     #              #  #  #           #
#  #  #  #  #######  ####  #  #############  ####  #  #######  #######  #  ####  #  #  ####  ####
#  #  #     #  #        #           #  #  #     #     #  #     #        #                 #  #  #
#  #######  #  ##########  ####  ####  #  ##########  #  #  #  #  #######  #######  #  #  ####  #
#        #  #           #  #           #     #     #     #  #  #        #        #  #  #  #     #
#  #  #  #######  #  #  #  ####  ####  ####  #  #  #  #  #  #  #  ##########  #  #######  ####  #
#  #  #  #        #  #  #  #     #  #  #        #  #  #     #     #  #        #  #  #  #        #
#  #  #  #  ##########  ##########  ##########  ##########  #######  #######  #  #  #  ####  ####
#  #  #           #        #  #        #  #        #     #  #     #        #  #  #           #  #
#  ####  #######  #######  #  #  #  ####  #  ##########  ####  #  #  #  #############  #######  #
#  #     #  #  #  #     #  #  #  #           #           #  #  #     #           #  #  #     #  #
####  ####  #  #######  #  #  #  ####  ##########  #######  #  #  ################  #  #  #  #  #
#        #  #        #           #     #                       #                 #     #  #     #
#  #  ####  #  #######  #######  ####  #  #######  ################  #  #  ####  #  ####  #  ####
#  #  #     #     #  #  #        #  #  #  #        #  #  #           #  #  #  #        #  #     #
#  ####  ####  ####  ####  #  ####  #  #############  #  #  #######  #  #  #  #######  #  #  ####
#  #  #        #           #     #              #           #        #  #        #        #     #
####  #  #############  #######  #############  #  ####  ##########  ##########  #  #  #  ####  #
#                       #        #     #     #  #  #        #           #  #     #  #  #     #  #
#  #  ####  #######  ####  ##########  #  #  ####  #######  #  #  ####  #  #######  ####  #  ####
#  #  #     #  #     #     #              #     #  #     #  #  #  #  #  #        #  #     #     #
##########  #  #######  ##########  ####  ####  ####  #  #  ####  #  #  #  #######  #######  #  #
#  #  #  #  #              #           #  #  #     #  #     #     #              #  #     #  #  #
#  #  #  #  ##########  #######  ##########  #  #  #  #######  #  ####  #  #  ####  #  #######  #
#  #  #     #              #  #  #     #  #  #  #  #  #        #  #  #  #  #     #  #     #  #  #
#  #  #  #  ################  #  #  ####  #  #  #  ####  #######  #  ###################  #  #  #
#        #           #  #           #        #  #  #     #     #        #        #        #     #
#  ##########  #  #  #  #  #  #  #######  #  ####  #  ####  #  ##########  #######  ####  ####  #
#        #     #  #     #  #  #  #        #                 #                 #     #           
##############################################################################################  
