#################################################################
#   #           #             # # #       #     # #   #     #   #
### ### ### ####### ### ####### # # ### ##### # # ### ##### # ###
#     #   #     # #   # #   #     #   #     # #       #         #
### ### ##### # # ##### # ### ### # # ##### # ### # ### ##### # #
# #   # #     # #     #   # # #     #   #     #   # # #   # # # #
# # ### ##### # ### ### # # # # # ### # ##### ### ### ### # ### #
#   # # #   # # #       #   # # # # # # #     #       # #     # #
# ### ##### # ### ####### # # ### # # # ### # ######### ##### # #
#     #   # # #   # #   # #     # #   #   # # # #             # #
# ##### ### # # # # ### ### ########### # ### # # ### # ### #####
#   #         # # #   # #   #       #   # #   #     # # # #     #
### # ### ##### ### # # ##### # ### # ##### ### ### ### # # # ###
# # #   #           #   # # # # #   #   #         # #   #   # # #
# # # ##### ######### # # # ### ### ####### ##### ### ##### ### #
#     #   #       # # # #         #   #     # # #   # #     #   #
# ####### # ##### # ############# # ### ##### # # # # ### # ### #
# # # #       # #       #       # #   #       #   # #   # # #   #
# # # # ### ### ### ####### ### ### ########### ####### ### ### #
# # #   #   #     #       # # # #       # #   #     # # #       #
### # # ##### ### ######### # ####### ### ### # ### # # ### #####
#     #     # #   #   # # # #     #     #     #   # #     #   # #
### ####### # # ##### # # # # ### ### ##### ### ######### ##### #
# # # #   #   # #   #   #       #     # #       #         # #   #
# # # # ##### ### ##### # ##### # ### # # ############# # # # # #
#   # # #     #   # #   #   #   #   #               #   #     # #
##### # ### ##### # # ### ##### ##### ##### # ############# # # #
#     #   #   #         #   #     # # #     # #   # #     # # # #
# # ##### # ####### ############# # ####### # # ### # # ### # # #
# # #                           # # # #     #   #   # #     # # #
# ########### ##### # # ### ####### # ### # ### # ### ### # ### #
#       #   #     # # # # #   #       #   # #     # # #   # #   #
# # ##### ##### # ### ### # ### # ### ######### # # ### # #######
# #           # # #       #     #   # #     #   #   # # # #     #
# # ######### ### ##### # # ####### ##### ########### ##### #####
# #   #   #       #   # # #   #   #   #   #         # # #       #
# # # # ##### ### # ######### ### # ##### ##### # ### # # ### ###
# # #   # #     #       # # #   #   # #   #     #           # # #
# ##### # ####### ### ### # ####### # # # # ##### ##### # # ### #
#     # #       # #       #   #   #   # # #     #     # # # #   #
# # # ##### # # # ### ### ### # # # # # # # ####### # ##### ### #
# # # #     # # # #   # # #     # # #   #   # #     # # # #     #
# # # # ####### ####### ####### ####### ##### ##### # # # ### ###
# # #       #     # #     # #     #   # #   #     # # #       # #
# ### ##### ##### # # # ### # ####### ### # # # ######### ##### #
# #   # # # #   # # # #       #       # # #   #       # # #   # #
### ### # ##### # # # ### ####### ##### # # ########### # # # # #
#     # #     #       #   #               #           #   # #   #
# # ### # ##### ##### ### # ##### ########### # # ### # ### # ###
# # #   #   # # #     # # # #     # # #       # # # #     # #   #
# ### ### ### ### # ### # ######### # # ##### # # # ##### # # ###
# # #     #       #   #         #       #     # #     #     #   #
### # ######### ##### ######### # ### ####### ####### # # # ### #
#               #     #   #   # # #     #       # #   # # #   # #
# # ### ##### ### ####### # # ### ##### # # ### # ##### ### # ###
# # #   # #   #   #         #   # #   # # # # # #     # #   #   #
####### # ##### ####### ### ### ### # # ### # # # ##### ##### # #
# # # # #         #       # # #   # #   #   #         # #   # # #
# #!# # ####### ##### ####### # # # ##### # ### # # ### # ##### #
# # #   #         # # #   # # # # # #     # # # # #   # #   # # #
# # # # ########### # # ### # # # ### ##### # ############# # # #
#     #       # #       #     # # #   #   #     #     #     #   #
# ####### # # # # # # ##### # ### # ### # ####### ### # ### ### #
#     #   # #   # # # #     #           #           #   #     #$#
#################################################################
